###########################
#                         #
#                         #
#                         #
#                         #
#                         #
#                 #      $#
#        #                #
#                   !     #
#                         #
#                         #
#@       #                #
##                        #