###########################
#                         #
#                ####### ##
#                #        #
#                #        #
#    $           #       ##
#                #        #
#                #        #
#    !           #       ##
##################        #
#       #   #             #
#@                        #
###  ##  ##  ##  ##########