###########################
#@# ###   # ############ ##
# # ### # # #           !##
#   #   #   # ####    #####
# # # ### ###    ## #######
# #   #     # ## ## ##    #
# ##### ###  ##  ## ## ## #
#  ###  ##  ### ###    ## #
###    ##  #### #######   #
### ##   ##     #  ## # ###
###   ####  ###### ## # ###
### !      ##            $#
###########################