###########################
#                         #
#                         #
#         !               #
#       #####             #
#                         #
# ##                      #
#                ###      #
#                         #
#    ##                   #
#                         #
#@    #                  $#
#######                 ###